{
  "Alliance": {
    "1": -1,
    "2": 301000,
    "3": 301000,
    "4": 301000,
    "5": 301000,
    "6": 301000,
    "7": 301000,
    "8": 301000,
    "10": 301000
  },
  "Citadel": {
    "1": -1,
    "2": 301001,
    "3": 301001,
    "4": 301001,
    "5": 301001,
    "6": 301001,
    "7": 301001,
    "8": 301001,
    "10": 301001
  },
  "Clearing": {
    "1": -1,
    "2": 301002,
    "3": 301002,
    "4": 301002,
    "5": 301002,
    "6": 301002,
    "7": 301002,
    "8": 301002,
    "10": 301002
  },
  "coastal": {
    "1": -1,
    "2": 301003,
    "3": 301003,
    "4": 301003,
    "5": 301003,
    "6": 301003,
    "7": 301003,
    "8": 301003,
    "10": 301003
  },
  "continental": {
    "1": -1,
    "2": 301004,
    "3": 301004,
    "4": 301004,
    "5": 301004,
    "6": 301004,
    "7": 301004,
    "8": 301004,
    "10": 301004
  },
  "Darkforest": {
    "1": -1,
    "2": 301005,
    "3": 301005,
    "4": 301005,
    "5": 301005,
    "6": 301005,
    "7": 301005,
    "8": 301005,
    "10": 301005
  },
  "Desertridge": {
    "1": -1,
    "2": 301006,
    "3": 301006,
    "4": 301006,
    "5": 301006,
    "6": 301006,
    "7": 301006,
    "8": 301006,
    "10": 301006
  },
  "Goldmountain": {
    "1": -1,
    "2": 301007,
    "3": 301007,
    "4": 301007,
    "5": 301007,
    "6": 301007,
    "7": 301007,
    "8": 301007,
    "10": 301007
  },
  "highland": {
    "1": -1,
    "2": 301008,
    "3": 301008,
    "4": 301008,
    "5": 301008,
    "6": 301008,
    "7": 301008,
    "8": 301008,
    "10": 301008
  },
  "Hillcountry": {
    "1": -1,
    "2": 301009,
    "3": 301009,
    "4": 301009,
    "5": 301009,
    "6": 301009,
    "7": 301009,
    "8": 301009,
    "10": 301009
  },
  "Inland": {
    "1": -1,
    "2": 301010,
    "3": 301010,
    "4": 301010,
    "5": 301010,
    "6": 301010,
    "7": 301010,
    "8": 301010,
    "10": 301010
  },
  "Insideout": {
    "1": -1,
    "2": 301011,
    "3": 301011,
    "4": 301011,
    "5": 301011,
    "6": 301011,
    "7": 301011,
    "8": 301011,
    "10": 301011
  },
  "landnomad": {
    "1": -1,
    "2": 301012,
    "3": 301012,
    "4": 301012,
    "5": 301012,
    "6": 301012,
    "7": 301012,
    "8": 301012,
    "10": 301012
  },
  "Largeislands": {
    "1": -1,
    "2": 301013,
    "3": 301013,
    "4": 301013,
    "5": 301013,
    "6": 301013,
    "7": 301013,
    "8": 301013,
    "10": 301013
  },
  "mediterranean": {
    "1": -1,
    "2": 301014,
    "3": 301014,
    "4": 301014,
    "5": 301014,
    "6": 301014,
    "7": 301014,
    "8": 301014,
    "10": 301014
  },
  "megarandom": {
    "1": -1,
    "2": 301015,
    "3": 301015,
    "4": 301015,
    "5": 301015,
    "6": 301015,
    "7": 301015,
    "8": 301015,
    "10": 301015
  },
  "Muddywaters": {
    "1": -1,
    "2": 301016,
    "3": 301016,
    "4": 301016,
    "5": 301016,
    "6": 301016,
    "7": 301016,
    "8": 301016,
    "10": 301016
  },
  "Narrows": {
    "1": -1,
    "2": 301017,
    "3": 301017,
    "4": 301017,
    "5": 301017,
    "6": 301017,
    "7": 301017,
    "8": 301017,
    "10": 301017
  },
  "nomad": {
    "1": -1,
    "2": 301018,
    "3": 301018,
    "4": 301018,
    "5": 301018,
    "6": 301018,
    "7": 301018,
    "8": 301018,
    "10": 301018
  },
  "oasis": {
    "1": -1,
    "2": 301019,
    "3": 301019,
    "4": 301019,
    "5": 301019,
    "6": 301019,
    "7": 301019,
    "8": 301019,
    "10": 301019
  },
  "Oceanchannel": {
    "1": -1,
    "2": 301020,
    "3": 301020,
    "4": 301020,
    "5": 301020,
    "6": 301020,
    "7": 301020,
    "8": 301020,
    "10": 301020
  },
  "Oceanring": {
    "1": -1,
    "2": 301021,
    "3": 301021,
    "4": 301021,
    "5": 301021,
    "6": 301021,
    "7": 301021,
    "8": 301021,
    "10": 301021
  },
  "Plateaus": {
    "1": -1,
    "2": 301022,
    "3": 301022,
    "4": 301022,
    "5": 301022,
    "6": 301022,
    "7": 301022,
    "8": 301022,
    "10": 301022
  },
  "Rivercrossing": {
    "1": -1,
    "2": 301023,
    "3": 301023,
    "4": 301023,
    "5": 301023,
    "6": 301023,
    "7": 301023,
    "8": 301023,
    "10": 301023
  },
  "rivers": {
    "1": -1,
    "2": 301024,
    "3": 301024,
    "4": 301024,
    "5": 301024,
    "6": 301024,
    "7": 301024,
    "8": 301024,
    "10": 301024
  },
  "Sahara": {
    "1": -1,
    "2": 301025,
    "3": 301025,
    "4": 301025,
    "5": 301025,
    "6": 301025,
    "7": 301025,
    "8": 301025,
    "10": 301025
  },
  "Smallislands": {
    "1": -1,
    "2": 301026,
    "3": 301026,
    "4": 301026,
    "5": 301026,
    "6": 301026,
    "7": 301026,
    "8": 301026,
    "10": 301026
  },
  "Twinsettlements": {
    "1": -1,
    "2": 301027,
    "3": 301027,
    "4": 301027,
    "5": 301027,
    "6": 301027,
    "7": 301027,
    "8": 301027,
    "10": 301027
  }
}
